17 200
                                                                                                                                                                                                        
                                                                                                                                                                        7 7 7 7 7 7 7 7 7 7 7 7 7 7 7 7 
                                                                                                                                                                                                        
                                                                                                                                                                        7 7 7 7 7 7 7 7 7 7 7 7 7 7 7 7 
                                                                                                                                                                                                        
                                                                                                                                                                   D    7 7 7 7 7 7 7 7 7 7 7 7 7 7 7 7 
                                                S=====s                      F                                                                   F                0*1                                   
       $   $                F                   AH----a  o                              $$$      T                                                                      7 7 7 7 7 7 7 7 7 7 7 7 7 7 7 7 
     8 4 8 4                           $        A------=====s                                                                                                                                           
                                       3 8      A-----------awwwwwwwwwwwwwwwwww7 7 7 7 7 7 7 7 7 7 7     $               $             K   $O    K    $r    K  M        7 7 7 7 7 7 7 7 7 7 7 7 7 7 7 7 
              t     T                           A-----------a~~~~~~~~~~~~~~~~~~                         W               W          7 2345234523452345234523452345234523452345234523452345234523452345234
S====================s             K    O$$    MA-----------a~j~~~~~~~~~~~~~~~~7 7 7 7 7 7 7 7 7 7 7                                 ------H----------------------H-------------------------------------
A---------------H----a    $$r    G^^^^^^^^^^^^^^------------a~~~~~~~~~~~~~~~~~~                                 E               E  7 -------------------------------------------------------------------
A---H----------------a23452345234A----H-----------------H---a~~~~~~~~j~~~~~~~~~7 7 7 7 7 7 7 7 7 7 7                                 -------------------------------------------------------------------
A--------------------a~~~~~~~~~~~A--------------------------a~~~~~~~~~~~~~~~~~~                                                    7 -----------------H-------------------H-----------------------------
CBBBBBBBBBBBBBBBBBBBBL~~~~~j~~~~~RBBBBBBBBBBBBBBBBBBBBBBBBBBL~~~~~~~~~~~~~~~j~~7 7 7 7 7 7 7 7 7 7 7 tttttttttttttttttttttttttttttt  -------------------------------------------------------------------
===================================================================================================================================7====================================================================